#######
###  ##
#    ##
#  #  #
##    #
##  ###
#######
########
####  ##
##    ##
#   #  #
#  #   #
##    ##
##  ####
########
#######
##   ##
#    ##
#  #  #
##    #
##   ##
#######
########
##  #  #
##     #
##   ###
###   ##
#     ##
#  #  ##
########
#######
#  #  #
#     #
##   ##
#     #
#  #  #
#######
########
##  ####
#     ##
#  #  ##
##  #  #
##     #
####  ##
########
#######
#   ###
#    ##
#  #  #
##    #
###   #
#######
########
#  #  ##
#     ##
#   ####
###    #
##     #
##  #  #
########
#######
#  ####
#    ##
## #  #
##    #
####  #
#######